1011110010
1001011110
1111010110
0010111010
1111101100
0110001011
0100000110
0101100001
0111111100
0110000111